{
  "id": "spass_mit_flaggen 5",
  "structure": [
    [0,5,0,5,0,5,0,5,0,5,0,5,0,5,0,5],
    [5,5,5,5,5,5,5,5,5,5,5,5,5,5,5,5],
    [0,1,0,1,0,1,0,1,0,1,0,1,0,1,0,1],
    [0,0,0,0,0,0,0,0,0,0,0,0,0,0,0,0],
    [0,0,0,0,0,0,0,0,0,0,0,0,0,0,0,0],
    [3,3,0,0,3,3,0,0,3,3,0,0,3,3,0,0],
    [0,0,0,0,0,0,0,0,0,0,0,0,0,0,0,0],
    [0,0,2,2,0,0,2,2,0,0,2,2,0,0,2,2],
    [0,0,0,0,0,0,0,0,0,0,0,0,0,0,0,0],
    [1,1,0,0,1,1,0,0,1,1,0,0,1,1,0,0],
    [0,0,0,0,0,0,0,0,0,0,0,0,0,0,0,0],
    [0,0,0,0,0,0,0,0,0,0,0,0,0,0,0,0],
    [0,1,2,2,3,3,3,1,1,3,3,3,3,2,1,0],
    [5,5,5,0,0,0,0,0,0,0,0,0,0,5,5,5]
  ],
  "probability": {
    "dropProbability": 15,
    "positiveProbability": 1,
    "negativeProbability": 2
  },
  "multiplayer": 0
}