{
  "id": "spass_mit_flaggen 1",
  "structure": [
      [1,1,1,1,1,1,1,1,1,1,1,1,1,1,1,1],
      [0,0,0,0,0,0,0,0,0,0,0,0,0,0,0,0],
      [0,0,0,0,0,0,0,0,0,0,0,0,0,0,0,0],
      [1,1,1,1,1,1,1,1,1,1,1,1,1,1,0,0],
      [0,0,0,0,0,0,0,0,0,0,0,0,0,0,0,0],
      [0,0,0,0,0,0,0,0,0,0,0,0,0,0,0,0],
      [0,0,1,1,1,1,1,1,1,1,1,1,1,1,1,1],
      [0,0,0,0,0,0,0,0,0,0,0,0,0,0,0,0],
      [0,0,0,0,0,0,0,0,0,0,0,0,0,0,0,0],
      [1,1,1,1,1,1,1,1,1,1,1,1,1,1,0,0]
  ],
  "probability": {
      "dropProbability": 20,
      "positiveProbability": 1,
      "negativeProbability": 0
  },
  "multiplayer": 1
}