{
    "id": "multiplayer2",
    "structure": [
        [4,1,1,1,1,1,1,1,1,1,4],
        [4,1,1,1,1,1,1,1,1,1,4],
        [0,0,2,2,2,2,2,2,2,0,0],
        [0,0,0,1,1,1,1,1,0,0,0],
        [0,0,0,0,3,4,3,0,0,0,0],
        [4,4,0,0,0,5,0,0,0,4,4],
        [0,0,0,0,0,0,0,0,0,0,0],
        [0,0,0,0,0,0,0,0,0,0,0],
        [0,0,0,0,0,0,0,0,0,0,0],
        [0,0,0,0,0,0,0,0,0,0,0],
        [0,0,0,0,4,4,4,0,0,0,0]
    ],
    "probability": {
        "dropProbability": 20,
        "positiveProbability": 1,
        "negativeProbability": 0
    },
    "multiplayer": 2
}