{
  "id":"singleplayer_level3",
  "structure":[
    [2,2,2,2,2,2,2,2,2,2,2,2,2,2,2,2],
    [5,5,5,3,3,3,3,1,1,3,3,3,3,5,5,5],
    [0,0,0,0,0,1,5,0,0,5,1,0,0,0,0,0],
    [0,0,0,0,0,1,0,0,0,0,1,0,0,0,0,0],
    [0,0,0,0,0,1,2,0,0,2,1,0,0,0,0,0],
    [0,0,0,0,1,0,2,0,0,2,0,1,0,0,0,0],
    [0,0,0,0,1,0,0,0,0,0,0,1,0,0,0,0],
    [0,0,0,0,1,0,0,0,0,0,0,1,0,0,0,0],
    [0,0,0,1,0,0,0,0,0,0,0,0,1,0,0,0],
    [0,0,0,1,0,0,0,0,0,0,0,0,1,0,0,0],
    [0,0,0,1,0,0,0,0,0,0,0,0,1,0,0,0],
    [0,0,0,2,1,1,1,1,1,1,1,1,2,0,0,0],
    [0,0,2,2,0,0,0,4,0,0,0,0,2,2,0,0],
    [0,2,2,2,1,1,1,1,1,1,1,1,2,2,2,0],
    [2,2,2,0,0,0,0,0,0,0,0,0,0,2,2,2],
    [2,2,0,0,0,0,0,0,0,0,0,0,0,0,2,2],
    [2,1,1,1,1,1,1,1,1,1,1,1,1,1,1,2]
  ],
  "probability": {
    "dropProbability": 20,
    "positiveProbability": 1,
    "negativeProbability": 1
  },
  "multiplayer": 0
}