{
  "id": "spass_mit_flaggen 2",
  "structure": [
    [0,0,1,1,1,1,1,1,1,1,1,1,1,1,0,0],
    [0,0,0,1,1,1,1,1,1,1,1,1,1,0,0,0],
    [0,0,0,0,1,1,1,1,1,1,1,1,0,0,0,0],
    [0,0,0,0,0,1,1,1,1,1,1,0,0,0,0,0],
    [0,0,0,0,0,0,3,2,2,3,0,0,0,0,0,0],
    [0,0,0,0,0,0,0,3,3,0,0,0,0,0,0,0]
  ],
  "probability": {
    "dropProbability": 15,
    "positiveProbability": 5,
    "negativeProbability": 1
  },
  "multiplayer": 0
}