{
    "id": "multiplayer3",
    "structure": [
        [4,1,1,1,1,3,1,1,1,1,4,0,0,0,0,0],
        [0,0,1,1,1,3,1,1,1,0,0,0,0,0,0,0],
        [0,0,0,1,5,3,5,1,0,0,0,0,0,0,0,0],
        [3,0,0,0,0,0,0,0,0,0,3,0,0,0,0,0],
        [3,3,0,0,0,0,0,0,0,3,3,0,0,0,0,0],
        [3,3,3,0,0,0,0,0,3,3,3,0,0,0,0,0],
        [4,4,2,0,0,3,0,0,2,4,4,0,0,0,0,0],
        [2,0,0,0,2,0,2,0,0,0,2,0,0,0,0,0],
        [2,0,0,0,2,0,2,0,0,0,2,0,0,0,0,0],
        [1,0,1,0,1,0,1,0,1,0,1,0,0,0,0,0],
        [5,4,5,4,5,4,5,4,5,4,5,0,0,0,0,0]
    ],
    "probability": {
        "dropProbability": 20,
        "positiveProbability": 1,
        "negativeProbability": 1
    },
    "multiplayer": 2
}