{
  "id": "spass_mit_flaggen 3",
  "structure": [
    [1,1,1,1,1,1,1,1,1,1,1,1,1,1,1,1],
    [3,3,3,3,3,3,3,3,3,3,3,3,3,3,3,3],
    [4,4,4,4,4,4,4,4,4,4,4,4,4,4,4,4],
    [1,1,1,1,1,1,1,1,1,1,1,1,1,1,1,1],
    [1,1,1,1,1,1,1,1,1,1,1,1,1,1,1,1],
    [1,1,1,1,1,1,1,1,1,1,1,1,1,1,1,1]
  ]
}